0
1111111111
1111111111
1111111111
1111111111
1111111111
1111111111
1111111111
1111111111
1
2112112112
1112112111
1222222221
1211211121
1211211121
1222222221
1112112111
2112112112
2
2111221112
1211221121
1121221211
1112332111
1112332111
1121221211
1211221121
2111221112
3
2222222222
1311111131
2222222222
1311331131
1311331131
2222222222
1311111131
2222222222
4
4321001234
3333223333
2222112222
1311001131
1311001131
2222112222
3333223333
4321001234
5
4433223344
4433223344
3322112233
3311221133
3322112233
4433223344
4433223344
6
4444444444
3333333333
2222222222
1111111111
3333333333
2222222222
3333333333
4444444444